Acer x peronai Schwerin (= A. opalus x monspessulanum)
Achillea atrata x moschata = A.x kraettliana Brügg.
Aconitum degenii Gayer x A. variegatum = x A. hebegynum DC.)
Aconitum degenii x A. pilipes = A. x pilosiusculum (Seringe) Gayer
Aconitum lupicida Rchb. x A. lycoctonum L. em. Koelle = A. x wraberi Starmühler
Aconitum napellus L. em. Skalicky x A. variegatum L. = A. x schneeburgense Gayer
Aconitum pilipes x A. variegatum = A. x austriacum Mucher
Agrostis capillaris x stolonifera = A. x murbeckii
Agrostis capillaris x vinealis = A. ? x sanionis
Ajuga genevensis x pyramidalis = A.x adulterina Wallr.
Ajuga genevensis x reptans = A.x hybrida Kern.
Ajuga pyramidalis x reptans = A.x hampeana A.Braun & Vatke
Ajuga reptans x pyramidalis = A. x pseudopyramidalis
Alnus incana x viridis = A.x montana Brügg.
Amaranthus x ozanonii Thell. in Asch. & Graebn. (=A. hybridus L.x A. retroflexus L.)
Anacamptis pyramidalis x Gymnadenia conopsea = X Gymnanacamptis anacamptis
Anemone nemorosa x ranunculoides = A.x lipsiensis Beck
Apium nodiflorum x inundatum = a. x moorei (Syme) Druce
Artemisia vulgaris x verlotiorum = a. x wurzellii C.M.James & Stace
Asplenium ruta-muraria x septentrionale = A. x murbeckii
Asplenium septentrionale x trichomanes s.str. = A.x alternifolium Wulf
Aster laevis x novi-belgii = A. x versicolor
Aster laevis x novi-belgii = a. x versicolor Willd.
Aster novi-belgii x lanceolatus = A. x salignus
Athyrium iseanum x Athyrium oflitescens =Athyrium inabaense Serizawa
Bromus hordeaceus x lepidus = B. x pseudothominei
Calamagrostis varia x villosa = C.x prahliana Torges
Calystegia calystegia pulchra x silvatica = c. x howittiorum Brummitt
Cardamine alpina x resedifolia = C.x wettsteiniana O.E.Schulz
Cardamine pratensis x flexuosa = C. x fringsii
Carduus crispus x nutans = C. x stangii
Carduus crispus x personata = C.x subinteger Murr
Carex acutiformis x acuta = C. x subgracilis
Carex appropinquata x diandra = C.x limnogena Appel
Carex aquatilis x nigra = C. x hibernica
Carex atrata x norvegica = C.x candriani Kneucker
Carex brizoides L. x remota L. = C. ohmülleriana
Carex brizoides x leporina = C.x filkukae Podpera
Carex brunnescens x lachenalii = C.x zahnii Kneucker
Carex canescens L. x paniculata L. (Figert) = C. silesiaca Figert
Carex canescens x dioica = C.x microstachya Ehrh.
Carex davalliana Sm. x C. echinata Murray = C. paponii Muret
Carex davalliana x dioica = C.x figertii Asch. et Graebn.
Carex diandra x paniculata = C.x germanica K.Richt.
Carex digitata x ornithopoda = C.x duftii Hausskn
Carex dioica x stellulata = C.x gaudiniana Guthn.
Carex elata x nigra = C.x pseudoturfosa DT.et Sarnth.
Carex figertii (= c. dioeca x davalliana)  Ascherson & Graebner
Carex flava x hostiana = C.x xanthocarpa Degland
Carex flava x lepidocarpa = C.x pieperiana P.Junge
Carex flava x oederi = C.x ruedtii Kneucker
Carex gracilis x elata = C.x prolixa Fries
Carex gracilis x randalpina = C.x oenensis A.Neumann in Wallnoefer
Carex hostiana x lepidocarpa = C.x kyrtostyla Fingerh.
Carex hostiana x viridula = C. x fulva
Carex lachenalii x curta = C. x helvola
Carex lepidocarpa x oederi = C.schatzii Kneuck.
Carex nigra x bigelowii = C. x decolorans
Carex otrubae x remota = C. x pseudoaxillaris
Carex paniculata x remota = C.x boenninghauseniana Weihe
Carex recta x aquatilis = C. x grantii
Carex remota x vulpina = C.x axillaris Good.
Carex rostrata x vesicaria = C. x involuta
Carex rostrata x vesicaria = C.x pannewitziana Figert
Carex vesicaria x saxatilis = C. x grahamii
Carex x oberrodensis B. Wallnöfer = C. elata All. x C. randalpina B. Wallnöfer
Centaurea jacea L. x C. stoebe L. = C. hoedliana J. Wagner
Centaurea jacea ssp.jacea x pseudophrygia = C.x similata Hausskn.
Circaea lutetiana x alpina = C. x intermedia
Cirsium acaule x spinosissimum = C.x.fissibracteatum Peterm.
Cirsium arvense x oleraceum = C.x reichenbachianum Löhr
Cirsium arvense x palustre = C. x celakovskyanum Knaf
Cirsium eriophorum x vulgare = C.x gerhardti C.H. Schultz
Cirsium erisithale (L.) Scop. x C. oleraceum (L.) Scop. x C. spinosissimum (L.) Scop.= (C. triphilinum )
Cirsium erisithales x heterophyllum = C. x tappeineri (Rchb.f.) Treuinfels
Cirsium erisithales x oleraceum = C. x candolleanum Naegeli
Cirsium erisithales x palustre = C. x ochroleucum All.
Cirsium erisithales x rivulare = C. x praealpinum Beck
Cirsium erisithales x spinosissimum = C. x flavescens Koch
Cirsium heterophyllum (L.) Hill. x C. oleraceum (L.) Scop. = Cirsium x affine Tausch
Cirsium heterophyllum x palustre = C.x wankelii Reichardt
Cirsium heterophyllum x spinosissimum = C.x purpureum All.
Cirsium oleraceum (L.) Scop. x C. palustre (L.) Scop. = C. x hybridum Koch ex DC.
Cirsium oleraceum (L.) Scop. x C. palustre (L.) Scop. = C. x micranthum Treuinf.
Cirsium oleraceum x C. spinosissimum = C. x thomasii Naegeli
Cirsium palustre (L.) Scop. x C. tuberosum (L.) All. = C. semidecurrens
Cirsium palustre x arvense = C. x celakovskianum
Cirsium palustre x C. rivulare = C. x subalpinum Gaudin
Cirsium palustre x spinosissimum = C.x spinifolium Beck
Cirsium rivulare x spinosissimum = C. x schulzeanum Naegeli
Cirsium tuberosum x palustre = C. x semidecurrens
Cirsium x rigens = Cirsium acaulon x oleraceum
Cotoneaster frigidus x salicifolius = C. x watereri
Crataegus laevigata x rhipidophylla = C.x macrocarpa Hegetschw.
Crepis alpestris x pyrenaica = C.x helvetica Brügg.
Dactylorhiza incarnata x traunsteineri = D.x stenostachys Murr
Dactylorhiza maculata x purpurella = D. x formosa
Dactylorhiza majalis x traunsteineri = D.x dufftiana (M.Schulze
Doronicum pardalianches x plantagineum = D. x willdenowii
Drosera drosera rotundifolia x anglica = d. x obovata Mert. & W.D.J.Koch
Drosera rotundifolia x anglica = D. x obovata
Dryopteris dilatata x expansa = D. x ambroseae
Elytrigia repens x atherica = E. x drucei
Elytrigia repens x juncea = E. x laxa
Epilobium alsinifolium x anagallidifolium = E.x boissieri Haussk.
Epilobium alsinifolium x collinum = E.x huteri Borb.
Epilobium alsinifolium x montanum = E.x salicifolium Facch.
Epilobium alsinifolium x nutans = E.x finitimum Hausskn.
Epilobium alsinifolium x palustris = E.x haynaldianum Hausskn.
Epilobium alsinifolium x roseum = E.x gemmiferum Boreau
Epilobium collinum x montanum = E.x confine Hausskn.
Epilobium collinum x roseum = E.x glanduligerum Knaf.fil.
Epilobium epilobium hirsutum x parviflorum = e. x subhirsutum Gennari
Epilobium hirsutum x montanum = E. x erroneum
Epilobium obscurum x palustre = E. x schmidtianum
Epilobium palustre x roseum = E. x purpureum Fries
Epilobium parviflorum x roseum = E.x persicinum Rchb.
Epilobium tetragonum x ciliatum = E. x mentiens
Epipactis atrorubens (HOFFM. ex BERNH.) BESSER x helleborine (L.) CRANTZ = E.x schmalhausii K.Richter
Equisetum arvense x fluviatile = E.x litorale Kühlew.
Equisetum arvense x palustre = E. x rothmaleri
Equisetum fluviatile x arvense = E. x litorale
Equisetum fluviatile x palustre = E. x dycei
Equisetum hyemale x ramosissimum = E.x moorei Newm.
Equisetum hyemale x variegatum = E. x trachyodon
Equisetum pratense x sylvaticum = E. x mildeanum
Erica ciliaris x tetralix = E. x watsonii
Erigeron acris L. x Erigeron canadensis L. = Erigeron xhuelsenii Vatke
Euphrasia arctica x scottica = E. x venusta
Euphrasia micrantha x scottica = E. x electa
Euphrasia minima x officinalis ssp.rostkoviana = E.x drosocalyx Freyn
Euphrasia rostkoviana x nemorosa = e. x glanduligera
Euphrasia venusta = e. brevipila x e. scottica
Fallopia japonica x sachalinensis = F. x bohemica
Festuca pratensis x Lolium perenne = Festulolium ascendens (Retz) A.et G. - Festul asc
Festuca pratensis x Lolium perenne = Festulolium x loliaceum (Huds.) Fourn.
Galium galium verum x mollugo = g. x pomeranicum Retz.
Galium verum x mollugo = G. x pomeranicum
Geum rivale x urbanum = G. x intermedium
Glyceria fluitans x notata = G. x pedicellata
Gymnadenia odoratissima (L.) Rich. x Gymnadenia rhellicani (Teppner & Klein) Teppner & Klein = x Gymnigritella heufleri (A.K.) E.G.Camus
Helianthus rigidus x tuberosus = H.x laetiflorus Pers.
Hypericum perforatum x maculatum = H. x desetangsii
Ilex aquifolium x perado = I. x altaclerensis
Impatiens lateritia Culg. (=Kilimanjari x pseudoviola)
Isoetes lacustris x echinospora = I. x hickeyi
Juncus articulatus x acutiflorus = J. x surrejanus
Juncus effusus x conglomeratus = J. x kern-reichgeltii
Juncus effusus x inflexus = J.x diffusus Hoppe
Lolium perenne x multiflorum = L. x boucheanum
Luzula forsteri x pilosa = L. x borreri
Luzula luzuloides x nivea = L.x favrati K.Richter
Mentha aquatica x arvensis = M. verticillata L.
Mentha aquatica x arvensis = M.x verticillata L.
Mentha aquatica x spicata = M. x piperita
Mentha arvensis x aquatica = M. x verticillata
Mentha arvensis x aquatica x spicata = M. x smithiana
Mentha arvensis x longifolia = M.x dalmatica Tausch
Mentha arvensis x spicata = M. x gracilis
Mentha mentha arvensis x spicata = m. x gracilis Sole
Mentha mentha spicata x suaveolens = m. x villosa Huds.
Mentha spicata x suaveolens = M. x villosa
Mentha suaveolens x longifolia = M. x rotundifolia
Mimulus guttatus x cupreus = M. x burnetii
Mimulus guttatus x luteus = M. x robertsii
Myosotis scorpioides x laxa = M. x suzae
Narcissus tazetta (=Narcissus dubius Gauan X N. juncifolius)
Nasturtium microphyllum x officinale = N.x sterile (Airy Shaw) Oefel.
Nepenthes ampullaria x N. gracilis (= x N. trichocarpa)
Nepenthes ampullaria x N. rafflesiana (=N. x hookeriana)
Oenothera glazioviana x biennis = O. x fallax
Oenothera oenothera glazioviana x biennis = o. x fallax Renner
Orchis x hybrida (= militaris x purpurea)
Orchis x hybrida (= purpurea x militaris)
Pedicularis elongata x rostrato-capitata = P.x bohatschii Steininger
Pedicularis rostrato-capitata x tuberosa = P.x erubescens Kern.
Phyllitis phyllitis scolopendrium x asplenium adiantum-nigrum = x asplenophyllitis jacksonii Alston
Phyllitis phyllitis scolopendrium x asplenium obovatum = x asplenophyllitis microdon (T.Moore) Alston
Platanthera hybrida (= bifolia x chlorantha)
Platanus x hybrida = P x hispanica Miller ex Muech.
Poa annua x supina = P.x nannfeldtii Jirasek
Poa flexuosa x alpina = P. x jemtlandica
Polypodium vulgare x interjectum = P. x mantoniae
Polystichum aculeatum x lonchitis = P. x illyricum
Polystichum aculeatum x lonchitis = P.x illyricum (Borb.)Hayek
Polystichum polystichum setiferum x lonchitis = p. x lonchitiforme (Halcsy) Bech
Populus balsamifera x deltoides = P. x jackii
Potamogeton alpinus x crispus = P. x olivaceus
Potamogeton coloratus x gramineus = P. x billupsii
Potamogeton filiformis x pectinatus = P. x suecicus
Potamogeton friesii x crispus = P. x lintonii
Potamogeton gramineus x perfoliatus = P. x nitens
Potamogeton lucens x gramineus = P. x angustifolius
Potamogeton natans x gramineus = P. x sparganiifolius
Potamogeton pectinatus x vaginatus = P. x bottnicus
Potamogeton perfoliatus x crispus = P. x cooperi
Potentilla anglica x reptans = P. x mixta
Potentilla aurea x grandiflora = P.x peyritschii Zimmeter
Potentilla erecta x anglica = P. x suberecta
Potentilla potentilla erecta x reptans = p. x mixta
Primula auricula x hirsuta = P.x pubescens Jacq.
Primula glutinosa x minima = P.x floerkeana Schrad.
Prunus spinosa L. subsp. fruticans (Wehe) Nym. (=P. spinosa L. x P. domestica L. subsp. insitia (L.) C.K.
Prunus spinosa L. subsp. fruticans (Weihe) Nym. (=P. spinosa L. x P. domestica L. ssp. insitia (L.) C.K.
Quercus petraea x robur = Q. x rosacea
Ranunculus aquatilis x peltatus = R. x virzionensis
Ranunculus flammula x reptans = R. x levenensis
Ranunculus omiophyllus x tripartitus = R. x novae-forestae
Ranunculus trichophyllus x fluitans = R. x bachii
Rhododendron ferrugineum x hirsutum = R. x intermedium Tausch
Rorippa nasturtium-aquaticum x microphylla = R. x sterilis
Rorippa sylvestris x amphibia = R. x anceps
Rosa arvensis x canina = R. x irregularis
Rosa canina x caesia = R. x dumalis
Rosa canina x sherardii = R. x rothschildii
Rosa sherardii x mollis = R. x perthensis
Rosa spinosissima x canina = R. x hibernica
Rosa spinosissima x mollis = R. x sabinii
Rosa spinosissima x rubiginosa = R. x biturigensis
Rosa spinosissima x sherardii = R. x involuta
Rubus x pseudidaeus (Whe) Lej. (= R. caesius x R. idaeus)
Rumex conglomeratus x obtusifolius = r. x abortivus Ruhmer
Rumex conglomeratus x palustris = R. x wirtgenii
Rumex crispus x obtusifolius = R. x pratensis
Rumex longifolius x obtusifolius = R. x hybridus
Rumex sanguineus x obtusifolius = R. x dufftii
Rumex x pratensis M. et K. (=Rumex x acutus L.)
Sagina saginoides x procumbens = S. x normaniana
Salix appendiculata x aurita = S.x limnogena A.Kern.
Salix appendiculata x caprea = S.x macrophylla A. Kern
Salix appendiculata x helvetica = S.x khekii Wol.
Salix appendiculata x purpurea = S.x austriaca Host
Salix appendiculata x waldsteiniana = S.x ramosissima A. et E.Camus
Salix aurita x caprea = S.x capreola A.Kern
Salix aurita x cinerea = S.x multinervis Doell
Salix aurita x lapponum = S. x obtusifolia
Salix aurita x myrsinifolia = S. x coriacea
Salix aurita x phylicifolia = S. x ludificans
Salix aurita x purpurea = S.x dichroa Doell
Salix aurita x repens = S. x ambigua
Salix caprea x cinerea = S. x reichardtii
Salix caprea x cinerea = S.x reichardtii A.Kern
Salix caprea x daphnoides = S.x erdingeri J.Kern
Salix caprea x eleagnos = S.x flueggeana Willd.
Salix caprea x myrsinifolia = S. x latifolia
Salix caprea x purpurea = S.x wimmeriana Gren. et Godr.
Salix caprea x viminalis = S.x smithiana Willd.
Salix cinerea x aurita = S. x multinervis
Salix cinerea x eleagnos = S.x capnoides
Salix cinerea x myrsinifolia = S. x strepida
Salix cinerea x myrsinifolia = S.x vaudensis Schleich.
Salix cinerea x phylicifolia = S. x laurina
Salix cinerea x repens = S. x subsericea
Salix cinerea x repens = S.x subsericae Doell.
Salix daphnoides x elaeagnos = S.x reuteri Moritzi
Salix elaeagnos x purpurea = S.x wichurae Pokorny
Salix euxina x alba = S. x fragilis
Salix glabra x retusa = S.x fenzliana A.Kern.
Salix glaucosericea x retusa = S.x elaeagnoides Schleich
Salix helvetica x waldsteiniana = S.x huteri Kern.
Salix myrsinifolia ssp. myrsinifolia <=> phylicifolia
Salix myrsinifolia x phylicifolia = S. x tetrapla
Salix purpurea x aurita x phylicifolia = S. x sesquitertia
Salix purpurea x cinerea = S. x pontederiana
Salix purpurea x viminalis = S. x rubra
Salix purpurea x viminalis = S.x rubra Huds.
Salix repens x herbacea = S. x cernua
Salix reticulata x waldsteiniana = S.x ganderi Huter ex K.Richt.
Salix viminalis x aurita = S. x fruticosa
Salix viminalis x caprea = S. x smithiana
Salix viminalis x caprea x cinerea = S. x calodendron
Salix viminalis x cinerea = S. x holosericea
Saxifraga aizoides x mutata = S.x hausmannii Kerner
Saxifraga biflora x oppositifolia = S.x kochii Hornung
Saxifraga spathularis x hirsuta = S. x polita
Saxifraga umbrosa x spathularis = S. x urbium
Schoenoplectus lacustris x triqueter = S.x carinatus (Sm.) Palla
Scutellaria galericulata x hastfolia = S. x neumannii
Senecio alpinus x jacobaea = S.x reisachii Grembl.
Senecio cacaliaster x hercynicus = S.x austriacus Herborg
Senecio cf. vernalis W. & K. x vulgaris = S. x helwingii
Senecio cineraria x jacobaea = s. x albescens Burb. & Colgan
Senecio erucifolius x jacobaea = S.x liechtensteinensis Murr
Senecio jacobaea x aquaticus = S. x ostenfeldii
Senecio sylvaticus x viscosus = S.x viscidulus Scheele
Solidago canadensis x virgaurea = S.x niederederi Khek.
Sorbus aucuparia x aria = S. x thuringiaca
Sorbus aucuparia x aria = s. x thuringiaca (Ilse) Fritsch
Spiraea alba x douglasii = S. x billardii
Spiraea salicifolia x alba = S. x rosalba
Spiraea salicifolia x douglasii = S. x pseudosalicifolia
Spiraea spiraea salicifolia x alba = s. x rosalba Dippel
Spiraea spiraea salicifolia x douglasii = s. x pseudosalicifolia Silverside
Stachys sylvatica x palustris = S. x ambigua
Symphytum officinale x asperum = S. x uplandicum
Thymus humifusus Bernh. x Thymus preacox Opiz = Th. x schwindii Machule
Thymus oenipontanus x Thymus rudis = Thymus x bulsanensis Ronn. Mach.
Thymus oenipotanus H. Br. x Thymus pulegioides L. = Tymus junctus H. Br.
Thymus praecox Opiz x Thymus vallicola = Thymus schinzii Ronn.
Thymus praecox x pulegioides = T.x reineggeri Opiz
Thymus praecox x Thymus pulegioides = T.x reineggeri Opiz
Tilia platyphyllos x cordata = t. x europaea L.
Typha latifolia x angustifolia = T. x glauca
Typha x glauca Godr. [= T. angustifolia x latifolia
Verbascum blattaria x nigrum = v. x intermedium
Verbascum nigrum x lychnitis = v. x incanum Gaudin
Verbascum thapsus x lychnitis = v. x thapsi L.
Viola canina x persicifolia = V. x ritschliana
Viola tricolor x arvensis = V. x contempta
Viola x uechtritziana Borb. (= V. mirabilis L. x riviniana Reichenb.)
